#######
#-#-#-#
###-###
#-----#
###-###
#-#-#-#
#######
