-------------------#-------------
-#-----#---#-#---#-#-#-------#---
-#-----##-##-#---#-#-#------#-#--
-#-----#-#-#-#---#-#-#------#-#--
-#-----#---#-#---#-#-#-----#####-
-#####-#---#--###--#-#####-#---#-
-------------------#-------------
