###################
#--------#--------#
#-##-###-#-###-##-#
#-----------------#
#-##-#-#####-#-##-#
#----#---#---#----#
####-###-#-###-####
---#-#-------#-#---
####-#-#####-#-####
#------#---#------#
####-#-#####-#-####
---#-#-------#-#---
####-#-#####-#-####
#--------#--------#
#-##-###-#-###-##-#
#--#-----------#--#
##-#-#-#####-#-#-##
#----#---#---#----#
#-######-#-######-#
#-----------------#
###################
