----------
-########-
-#------#-
-########-
----------
